NO./texture/wall.xpm

11111111
10000001
10p00001
10000111
10000001
11101001
10000001
11111111