NO./textures/collectible.xpm
SO./textures/wall_colon.xpm
WE./textures/wall_up.xpm
EA./textures/wall.xpm
C 212,123,123
F 133,55,78

111111111    
11111111
1000000111111111
10S0000000000001
1000011111100011
10000001  111111
11101001
10000101
11111111