NO./textures/collectible.xpm
SO./textures/wall_colon.xpm
WE./textures/wall_up.xpm
EA./textures/collectible.xpm
C 212,123,123
F 133,55,78

11111111
10000001
10W00001
10000111
10000001
11101001
10000101
11111111